3 3 3 3 3 3 3 3 3 3 3 3 3 3 3 3
3 3 3 3 3 3 3 3 3 3 3 3 3 3 3 3
3 5 5 5 3 3 2 2 2 3 3 5 5 5 3 3
3 5 1 5 3 2 2 2 2 3 5 1 5 3 3 3
3 5 5 5 3 2 2 2 2 3 5 5 5 3 3 3
3 3 3 3 3 3 2 2 3 3 3 3 3 3 3 3
3 2 2 2 2 3 3 3 3 2 2 2 2 3 3 3
3 2 2 2 2 3 1 1 3 2 2 2 2 3 3 3
3 2 2 2 2 3 1 1 3 2 2 2 2 3 3 3
3 3 3 3 3 3 3 3 3 3 3 3 3 3 3 3
0 0 0 0 0 0 0 0 0 0 0 0 0 0 0 0
0 0 0 0 0 0 0 0 0 0 0 0 0 0 0 0