0 0 0 0 0 0 0 0 0 0 0 0 0 0 0 0 0 0 0 0 0 0 0 0 0 0 0 0 0 0 0 0 0 0 0 0 0 0 0 0 0 0 0 0 0 0 0 0 0 0 0 0 0 0 0 0 0 0 0 0 0 0 0 0 0 0 0 0 0 0 0 0 0 0 0 0 0 0 0 0 0 0 0 0 0 0 0 0 0 0 0 0 0 0 0 0 0 0 0 0 
0 0 0 0 0 0 0 0 0 0 0 0 0 0 0 0 0 0 0 0 0 0 0 0 0 0 0 0 0 0 0 0 0 0 0 0 0 0 0 0 0 0 0 0 0 0 0 0 0 0 0 0 0 0 0 0 0 0 0 0 0 0 0 0 0 0 0 0 0 0 0 0 0 0 0 0 0 0 0 0 0 0 0 0 0 0 0 0 0 0 0 0 0 0 0 0 0 0 0 0 
0 0 0 0 0 0 0 0 0 0 0 0 0 72 73 73 73 73 74 0 0 0 0 0 0 0 0 0 0 0 0 0 0 0 0 0 0 0 0 0 0 0 0 0 0 0 0 0 0 0 0 0 0 0 0 0 0 0 0 0 0 0 0 0 0 0 0 0 0 0 0 0 0 0 0 0 0 0 0 0 0 0 0 0 0 0 0 0 0 0 0 0 0 0 0 0 0 0 0 0 
0 0 0 0 0 0 0 0 0 0 0 0 72 69 71 71 71 71 71 73 73 73 73 73 73 73 74 0 0 0 0 0 0 0 0 0 0 0 0 0 0 0 0 0 0 0 0 0 0 0 0 0 0 0 0 0 0 0 0 0 0 0 0 0 0 0 0 0 0 0 0 0 0 0 0 0 0 0 0 0 0 0 0 0 0 0 0 0 0 0 0 0 0 0 0 0 0 0 0 0 
0 0 0 0 0 0 0 0 0 0 0 0 76 71 71 71 71 71 71 71 71 70 70 70 71 71 71 73 73 73 73 73 74 0 0 0 0 0 0 0 0 0 0 0 0 0 0 0 0 0 0 0 0 0 0 0 0 0 0 0 0 0 0 0 0 0 0 0 0 0 0 0 0 0 0 0 0 0 0 0 0 0 0 0 0 0 0 0 0 0 0 0 0 0 0 0 0 0 0 0 
0 0 0 0 0 0 0 0 0 0 0 72 71 71 71 71 71 71 71 71 71 71 71 71 71 71 71 71 71 71 71 69 69 73 74 0 0 0 0 0 0 0 0 0 0 0 0 0 0 0 0 0 0 0 0 0 0 0 0 0 0 0 0 0 0 0 0 0 0 0 0 0 0 0 0 0 0 0 0 0 0 0 0 0 0 0 0 0 0 0 0 0 0 0 0 0 0 0 0 0 
0 0 0 0 0 0 0 0 0 72 73 71 71 71 71 17 17 17 17 17 17 71 71 71 71 71 71 71 71 71 71 71 71 71 69 74 0 0 0 0 0 0 0 0 0 0 0 0 0 0 0 0 0 0 0 0 0 0 0 0 0 0 0 0 0 0 0 0 0 0 0 0 0 0 0 0 0 0 0 0 0 0 0 0 0 0 0 0 0 0 0 0 0 0 0 0 0 0 0 0 
0 0 0 0 0 0 0 0 0 76 71 71 71 17 17 1 1 1 1 1 17 17 17 17 17 17 71 71 71 71 71 71 71 71 71 69 74 0 0 0 0 0 0 0 0 0 0 0 0 0 0 0 0 0 0 0 0 0 0 0 0 0 0 0 0 0 0 0 0 0 0 0 0 0 0 0 0 0 0 0 0 0 0 0 0 0 0 0 0 0 0 0 0 0 0 0 0 0 0 0 
0 0 0 0 0 0 0 0 72 71 71 71 17 17 1 2 1 2 16 1 1 1 1 1 1 17 71 71 71 71 71 71 71 71 71 71 69 73 73 74 0 0 0 0 0 0 0 0 0 0 0 0 0 0 0 0 0 0 0 0 0 0 0 0 0 0 0 0 0 0 0 0 0 0 0 0 0 0 0 0 0 0 0 0 0 0 0 0 0 0 0 0 0 0 0 0 0 0 0 0 
0 0 0 0 0 0 0 72 71 71 71 17 17 17 1 1 20 21 21 22 1 1 1 2 1 17 17 17 71 71 71 71 71 71 71 71 71 71 71 69 74 0 0 0 0 0 0 0 0 0 0 0 0 0 0 0 0 0 0 0 0 0 0 0 0 0 0 0 0 0 0 0 0 0 0 0 0 0 0 0 0 0 0 0 0 0 0 0 0 0 0 0 0 0 0 0 0 0 0 0 
0 0 0 0 0 0 0 76 71 71 17 17 1 16 20 21 31 18 28 27 1 1 1 1 1 1 1 17 17 71 71 71 71 71 71 71 71 71 71 71 69 74 0 0 0 0 0 0 0 0 0 0 0 0 0 0 0 0 0 0 0 0 0 0 0 0 0 0 0 0 0 0 0 0 0 0 0 0 0 0 0 0 0 0 0 0 0 0 0 0 0 0 0 0 0 0 0 0 0 0 
0 0 0 0 0 0 72 71 71 17 17 1 1 1 25 29 18 28 27 2 1 1 1 2 1 1 1 17 17 71 71 71 71 71 71 71 71 71 71 71 71 62 0 0 0 0 0 0 0 0 0 0 0 0 0 0 0 0 0 0 0 0 0 0 0 0 0 0 0 0 0 0 0 0 0 0 0 0 0 0 0 0 0 0 0 0 0 0 0 0 0 0 0 0 0 0 0 0 0 0 
0 0 0 0 0 72 71 71 71 17 1 1 2 1 16 25 29 24 2 1 2 1 1 2 1 2 1 17 17 71 71 71 71 71 71 71 71 71 71 71 71 69 74 0 0 0 0 0 0 0 0 0 0 0 0 0 0 0 0 0 0 0 0 0 0 0 0 0 0 0 0 0 0 0 0 0 0 0 0 0 0 0 0 0 0 0 0 0 0 0 0 0 0 0 0 0 0 0 0 0 
0 0 0 72 73 71 71 71 71 17 1 1 1 1 2 1 25 27 2 12 10 13 1 1 1 1 1 17 17 71 71 71 71 71 71 71 71 71 71 71 71 69 62 0 0 0 0 0 0 0 0 0 0 0 0 70 0 0 0 0 0 0 0 0 0 0 0 0 0 0 0 0 0 0 0 0 0 0 0 0 0 0 0 0 0 0 0 0 0 0 0 0 0 0 0 0 0 0 0 0 
0 0 0 76 71 71 71 71 71 17 1 2 2 1 1 2 1 2 1 8 3 7 1 2 1 1 17 17 17 70 71 71 71 71 71 71 71 71 71 71 71 71 62 0 0 0 0 0 0 0 0 0 0 0 0 0 0 0 0 0 0 0 0 0 0 0 0 0 0 0 0 0 0 0 0 0 0 0 0 0 0 0 0 0 0 0 0 0 0 0 0 0 0 0 0 0 0 0 0 0 
0 0 72 69 71 71 71 71 71 17 17 17 1 1 1 2 1 1 2 14 5 15 1 1 1 17 17 17 17 71 71 71 71 71 71 71 71 71 71 71 71 71 62 0 0 0 0 0 0 0 0 0 0 0 0 0 0 0 0 0 0 0 0 0 0 0 0 0 0 0 0 0 0 0 0 0 0 0 0 0 0 0 0 0 0 0 0 0 0 0 0 0 0 0 0 0 0 0 0 0 
0 0 76 71 71 71 71 71 71 71 70 17 17 17 1 1 2 1 1 2 1 1 1 17 17 17 17 17 17 70 70 70 71 71 71 71 71 71 71 71 71 71 62 0 0 0 0 0 0 0 0 0 0 0 0 0 0 0 0 0 0 0 0 0 0 0 0 0 0 0 0 0 0 0 0 0 0 0 0 0 0 0 0 0 0 0 0 0 0 0 0 0 0 0 0 0 0 0 0 0 
0 0 76 71 71 71 71 71 71 71 70 70 17 17 17 17 1 1 2 1 2 1 17 17 17 17 17 17 17 70 70 70 71 71 71 71 71 71 71 71 71 71 62 0 0 0 0 0 0 0 0 0 0 0 0 0 0 0 0 0 0 0 0 0 0 0 0 0 0 0 0 0 0 0 0 0 0 0 0 0 0 0 0 0 0 0 0 0 0 0 0 0 0 0 0 0 0 0 0 0 
0 0 76 71 71 71 70 70 71 71 70 70 17 17 17 17 17 17 17 17 17 17 17 17 17 17 17 17 70 70 70 70 71 71 71 71 71 71 71 71 71 71 62 0 0 0 0 0 0 0 0 0 0 0 0 0 0 0 0 0 0 0 0 0 0 0 0 0 0 0 0 0 0 0 0 0 0 0 0 0 0 0 0 0 0 0 0 0 0 0 0 0 0 0 0 0 0 0 0 0 
0 72 71 71 71 71 70 70 70 71 71 71 70 70 17 17 17 17 17 17 17 17 17 17 17 17 17 70 70 70 70 70 71 71 71 71 71 71 71 71 71 71 69 74 0 0 0 0 0 0 0 0 0 0 0 0 0 0 0 0 0 0 0 0 0 0 0 0 0 0 0 0 0 0 0 0 0 0 0 0 0 0 0 0 0 0 0 0 0 0 0 0 0 0 0 0 0 0 0 0 
0 76 71 71 71 71 71 70 70 71 71 70 70 70 70 70 70 70 17 17 17 17 17 17 17 70 70 70 70 69 70 70 71 72 73 73 73 74 71 71 71 71 71 62 0 0 0 0 0 0 0 0 0 0 0 0 0 0 0 0 0 0 0 0 0 0 0 0 0 0 0 0 0 0 0 0 0 0 0 0 0 0 0 0 0 0 0 0 0 0 0 0 0 0 0 0 0 0 0 0 
0 76 71 71 71 71 71 71 71 71 71 71 71 70 71 70 70 70 70 70 70 70 70 70 70 70 70 70 70 69 69 69 72 77 77 77 77 77 74 71 71 71 71 69 74 0 0 0 0 0 0 0 0 0 0 0 0 0 0 0 0 0 0 0 0 0 0 0 0 0 0 0 0 0 0 0 0 0 0 0 0 0 0 0 0 0 0 0 0 0 0 0 0 0 0 0 0 0 0 0 
0 76 71 71 71 71 70 70 70 70 71 71 71 71 71 71 70 70 70 70 70 70 70 70 69 69 69 69 69 69 72 73 77 77 77 69 69 69 77 74 71 71 71 71 69 74 0 0 0 0 0 0 0 0 0 0 0 0 0 0 0 0 0 0 0 0 0 0 0 0 0 0 0 0 0 0 0 0 0 0 0 0 0 0 0 0 0 0 0 0 0 0 0 0 0 0 0 0 0 0 
0 76 71 71 71 71 70 71 71 71 71 71 70 70 71 71 71 71 71 71 71 71 71 69 69 69 71 72 73 73 71 71 71 72 74 69 69 69 77 77 74 71 71 71 62 67 0 0 0 0 0 0 0 0 0 0 0 0 0 0 0 0 0 0 0 0 0 0 0 0 0 0 0 0 0 0 0 0 0 0 0 0 0 0 0 0 0 0 0 0 0 0 0 0 0 0 0 0 0 0 
0 76 71 71 71 71 71 70 71 71 71 71 70 71 71 71 71 71 71 71 71 69 69 69 71 71 72 77 69 69 69 72 73 77 77 73 74 69 77 77 77 74 71 71 62 0 0 0 0 0 0 0 0 0 0 0 0 0 0 0 0 0 0 0 0 0 0 0 0 0 0 0 0 0 0 0 0 0 0 0 0 0 0 0 0 0 0 0 0 0 0 0 0 0 0 0 0 0 0 0 
0 76 71 71 71 71 71 71 70 70 70 70 70 71 71 70 70 70 70 71 71 69 69 69 71 72 77 69 69 69 72 69 77 77 77 69 62 69 69 77 77 62 71 71 62 0 0 0 0 0 0 0 0 0 0 0 0 0 0 0 0 0 0 0 0 0 0 0 0 0 0 0 0 0 0 0 0 0 0 0 0 0 0 0 0 0 0 0 0 0 0 0 0 0 0 0 0 0 0 0 
0 76 71 71 71 71 71 71 70 70 71 70 70 70 71 71 71 71 71 71 70 70 71 71 69 76 69 77 77 77 65 76 69 77 77 77 69 74 71 77 77 62 71 71 62 0 0 0 0 0 0 0 0 0 0 0 0 0 0 0 0 0 0 0 0 0 0 0 0 0 0 0 0 0 0 0 0 0 0 0 0 0 0 0 0 0 0 0 0 0 0 0 0 0 0 0 0 0 0 0 
0 64 76 71 71 71 71 70 70 71 71 71 77 77 71 71 70 71 70 70 71 69 69 71 69 76 77 77 77 77 71 65 67 76 70 62 65 65 71 77 77 62 71 71 62 0 0 0 0 0 0 0 0 0 0 0 0 0 0 0 0 0 0 0 0 0 0 0 0 0 0 0 0 0 0 0 0 0 0 0 0 0 0 0 0 0 0 0 0 0 0 0 0 0 0 0 0 0 0 0 
0 0 76 71 71 71 70 70 70 71 71 77 77 71 77 71 70 70 70 70 77 77 69 71 72 77 77 77 71 69 69 69 69 65 65 65 77 69 77 77 62 64 71 71 62 0 0 0 0 0 0 0 0 0 0 0 0 0 0 0 0 0 0 0 0 0 0 0 0 0 0 0 0 0 0 0 0 0 0 0 0 0 0 0 0 0 0 0 0 0 0 0 0 0 0 0 0 0 0 0 
0 0 76 71 71 71 70 70 71 70 71 70 70 70 71 71 71 71 77 77 77 71 69 69 65 76 69 69 62 64 76 69 69 69 69 69 69 62 64 64 64 71 71 62 67 0 0 0 0 0 0 0 0 0 0 0 0 0 0 0 0 0 0 0 0 0 0 0 0 0 0 0 0 0 0 0 0 0 0 0 0 0 0 0 0 0 0 0 0 0 0 0 0 0 0 0 0 0 0 0 
0 0 64 76 71 71 71 71 71 71 70 70 71 71 71 77 77 77 77 71 71 71 69 69 69 64 64 64 64 69 64 64 64 76 69 69 62 64 71 71 71 62 64 67 0 0 0 0 0 0 0 0 0 0 0 0 0 0 0 0 0 0 0 0 0 0 0 0 0 0 0 0 0 0 0 0 0 0 0 0 0 0 0 0 0 0 0 0 0 0 0 0 0 0 0 0 0 0 0 0 
0 0 0 64 70 71 71 71 71 71 71 71 71 70 71 71 71 71 71 71 71 71 69 69 69 71 71 71 71 71 71 71 71 64 64 64 64 71 71 71 62 67 0 0 0 0 0 0 0 0 0 0 0 0 0 0 0 0 0 0 0 0 0 0 0 0 0 0 0 0 0 0 0 0 0 0 0 0 0 0 0 0 0 0 0 0 0 0 0 0 0 0 0 0 0 0 0 0 0 0 
0 0 0 0 67 64 64 76 71 71 71 70 70 70 71 71 70 71 71 71 71 71 69 69 69 69 69 69 69 69 69 69 69 69 71 71 71 71 71 62 67 0 0 0 0 0 0 0 0 0 0 0 0 0 0 0 0 0 0 0 0 0 0 0 0 0 0 0 0 0 0 0 0 0 0 0 0 0 0 0 0 0 0 0 0 0 0 0 0 0 0 0 0 0 0 0 0 0 0 0 
0 0 0 0 0 0 0 67 64 64 76 71 71 71 71 71 70 70 70 70 71 71 71 71 71 71 71 71 71 71 71 71 71 71 71 71 77 71 62 67 0 0 0 0 0 0 0 0 0 0 0 0 0 0 0 0 0 0 0 0 0 0 0 0 0 0 0 0 0 0 0 0 0 0 0 0 0 0 0 0 0 0 0 0 0 0 0 0 0 0 0 0 0 0 0 0 0 0 0 0 
0 0 0 0 0 0 0 0 0 0 67 64 76 71 62 64 64 76 62 64 64 64 64 67 76 70 62 66 66 66 66 67 76 71 71 71 62 66 67 0 0 0 0 0 0 0 0 0 0 0 0 0 0 0 0 0 0 0 0 0 0 0 0 0 0 0 0 0 0 0 0 0 0 0 0 0 0 0 0 0 0 0 0 0 0 0 0 0 0 0 0 0 0 0 0 0 0 0 0 0 
0 0 0 0 0 0 0 0 0 0 0 0 67 64 67 0 0 64 67 0 0 0 0 0 76 70 62 0 0 0 0 0 66 66 66 66 67 0 0 0 0 0 0 0 0 0 0 0 0 0 0 0 0 0 0 0 0 0 0 0 0 0 0 0 0 0 0 0 0 0 0 0 0 0 0 0 0 0 0 0 0 0 0 0 0 0 0 0 0 0 0 0 0 0 0 0 0 0 0 0 
0 0 0 0 0 0 0 0 0 0 0 0 0 0 0 0 0 0 0 0 0 0 0 0 76 70 62 0 0 0 0 0 0 0 0 0 0 0 0 0 0 0 0 0 0 0 0 0 0 0 0 0 0 0 0 0 0 0 0 0 0 0 0 0 0 0 0 0 0 0 0 0 0 0 0 0 0 0 0 0 0 0 0 0 0 0 0 0 0 0 0 0 0 0 0 0 0 0 0 0 
0 0 0 0 0 0 0 0 0 0 0 0 0 0 0 0 0 0 0 0 0 0 0 0 76 70 62 0 0 0 0 0 0 0 0 0 0 0 0 0 0 0 0 0 0 0 0 0 0 0 0 0 0 0 0 0 0 0 0 0 0 0 0 0 0 0 0 0 0 0 0 0 0 0 0 0 0 0 0 0 0 0 0 0 0 0 0 0 0 0 0 0 0 0 0 0 0 0 0 0 
0 0 0 0 0 0 0 0 0 0 0 0 0 0 0 0 0 0 0 0 0 0 0 0 76 70 62 0 0 0 0 0 0 0 0 0 0 0 0 0 0 0 0 0 0 0 0 0 0 0 0 0 0 0 0 0 0 0 0 0 0 0 0 0 0 0 0 0 0 0 0 0 0 0 0 0 0 0 0 0 0 0 0 0 0 0 0 0 0 0 0 0 0 0 0 0 0 0 0 0 
0 0 0 0 0 0 0 0 0 0 0 0 0 0 0 0 0 0 0 0 0 0 0 0 76 70 62 0 0 0 0 0 0 0 0 0 0 0 0 0 0 0 0 0 0 0 0 0 0 0 0 0 0 0 0 0 0 0 0 0 0 0 0 0 0 0 0 0 0 0 0 0 0 0 0 0 0 0 0 0 0 0 0 0 0 0 0 0 0 0 0 0 0 0 0 0 0 0 0 0 
0 0 0 0 0 0 0 0 0 0 0 0 0 0 0 0 0 0 0 0 0 0 0 0 76 70 62 0 0 0 0 0 0 0 0 0 0 0 0 0 0 0 0 0 0 0 0 0 0 0 0 0 0 0 0 0 0 0 0 0 0 0 0 0 0 0 0 0 0 0 0 0 0 0 0 0 0 0 0 0 0 0 0 0 0 0 0 0 0 0 0 0 0 0 0 0 0 0 0 0 
0 0 0 0 0 0 0 0 91 92 92 92 92 92 92 92 92 92 92 92 92 92 92 92 98 70 91 92 92 92 92 92 92 92 92 92 92 92 92 98 0 0 0 0 0 0 0 0 0 0 0 0 0 0 0 0 0 0 0 0 0 0 0 0 0 0 72 73 73 73 73 73 73 73 73 73 73 74 0 0 0 0 0 0 0 0 0 0 0 0 0 0 0 0 0 0 0 0 0 0 
0 0 0 0 0 0 0 0 100 96 105 105 105 105 105 105 105 105 105 105 105 105 105 95 93 90 104 95 105 105 105 105 105 105 105 105 105 105 96 100 0 0 0 0 0 0 0 0 0 0 0 0 0 0 0 0 0 0 0 0 0 0 0 72 73 73 77 77 69 69 69 69 69 69 69 69 69 77 74 0 0 0 0 0 0 0 0 0 0 0 0 0 0 0 0 0 0 0 0 0 
0 0 0 0 0 0 0 0 100 90 82 90 82 82 90 90 90 90 100 90 82 90 82 90 100 90 90 90 90 82 90 90 82 90 90 100 90 90 82 103 0 0 0 0 0 0 0 0 0 0 0 0 0 0 0 0 0 0 0 72 73 73 73 77 69 69 69 69 69 69 69 71 71 69 69 69 69 69 77 73 74 0 0 0 0 0 0 0 0 0 0 0 0 0 0 0 0 0 0 0 
0 0 0 0 0 0 0 0 100 90 91 92 92 92 90 91 92 92 101 90 92 92 92 92 101 92 92 92 92 92 92 92 92 98 90 100 90 99 90 103 0 0 0 0 0 0 0 0 0 0 0 0 0 0 0 0 72 73 73 77 69 69 69 69 69 69 71 71 69 69 71 69 71 69 69 69 69 69 69 69 77 73 73 73 73 74 0 0 0 0 0 0 0 0 0 0 0 0 0 0 
0 0 0 0 0 0 0 0 100 90 100 90 90 100 90 90 100 90 90 82 90 90 90 90 90 82 90 90 90 90 90 82 90 100 90 82 82 100 89 103 0 0 0 0 0 0 0 0 0 0 0 0 0 0 0 0 76 70 69 69 69 71 71 71 71 71 71 71 69 69 75 69 71 71 69 69 71 71 71 69 69 69 69 69 69 77 73 74 0 0 0 0 0 0 0 0 0 0 0 0 
0 0 0 0 0 0 0 0 100 90 100 90 91 92 92 92 92 92 92 92 92 92 98 90 91 92 92 92 92 92 92 98 90 100 92 92 92 101 90 103 0 0 0 0 0 0 0 0 0 0 0 0 0 0 0 72 70 69 69 71 71 70 71 71 70 71 69 69 72 73 77 74 69 71 69 69 71 70 71 71 69 69 69 69 71 71 69 77 74 0 0 0 0 0 0 0 0 0 0 0 
0 0 0 0 0 0 0 0 100 82 100 90 100 90 90 90 90 82 82 82 90 82 82 90 100 90 90 90 82 90 90 100 90 90 90 90 90 100 82 103 0 0 0 0 0 0 0 0 0 0 0 0 0 0 72 70 69 71 71 71 71 71 71 70 71 71 69 72 77 72 74 69 74 71 71 69 71 70 71 71 71 71 71 71 71 71 69 69 62 0 0 0 0 0 0 0 0 0 0 0 
0 0 0 0 0 0 0 0 100 90 100 82 100 90 91 92 92 92 92 92 92 92 92 92 101 90 91 92 92 92 92 101 92 92 92 92 90 80 90 103 0 0 0 0 0 0 0 0 0 0 0 0 0 72 70 69 69 71 71 70 70 70 70 70 71 71 71 76 72 69 69 74 69 74 69 71 71 70 70 70 70 71 71 71 71 69 69 69 77 74 0 0 0 0 0 0 0 0 0 0 
0 0 0 0 0 0 0 0 100 90 100 82 80 90 100 90 90 90 90 90 80 90 90 90 100 90 100 90 82 90 90 90 90 82 90 100 92 92 92 103 0 0 0 0 0 0 0 0 0 0 0 0 0 76 69 69 69 71 71 71 71 71 70 70 71 71 72 77 65 63 66 65 62 65 71 69 69 69 71 71 70 70 70 70 69 69 69 71 69 77 74 0 0 0 0 0 0 0 0 0 
0 0 0 0 0 0 0 0 100 82 90 82 91 92 92 92 92 92 98 90 91 92 98 90 90 90 100 80 91 92 92 98 90 99 90 90 90 100 90 103 73 73 73 73 73 73 73 73 73 73 73 73 73 70 69 69 71 69 71 70 71 70 70 71 71 71 64 76 69 65 69 69 62 71 69 69 71 71 69 71 70 70 71 71 71 69 71 71 69 77 77 74 0 0 0 0 0 0 0 0 
0 0 0 0 0 0 0 0 100 90 91 92 101 90 90 90 82 90 82 82 90 90 100 92 92 92 102 90 100 90 90 90 90 100 92 98 90 90 90 90 77 77 77 77 77 77 77 77 77 77 77 77 77 77 69 69 69 70 70 70 71 71 71 71 69 71 71 67 67 76 62 67 67 71 71 71 71 71 71 69 70 71 71 71 71 71 69 71 69 69 69 77 74 0 0 0 0 0 0 0 
0 0 0 0 0 0 0 0 100 82 100 90 100 98 90 91 92 92 92 92 98 90 90 82 82 90 90 82 100 92 92 92 92 101 90 90 90 100 90 103 77 77 77 77 77 77 77 77 77 77 77 77 77 77 69 69 71 71 70 71 71 69 71 71 71 71 71 69 71 64 67 69 69 69 71 71 71 71 71 71 71 69 69 69 71 69 69 69 69 69 69 69 62 0 0 0 0 0 0 0 
0 0 0 0 0 0 0 0 100 90 100 82 90 82 90 100 90 90 80 90 100 92 92 92 92 92 98 89 100 90 90 90 90 80 90 91 92 101 89 103 64 64 64 64 64 64 64 64 64 64 64 64 64 76 69 69 70 69 70 69 71 69 71 71 71 71 69 71 71 71 71 71 71 69 71 69 69 69 77 77 77 77 77 77 77 77 71 71 71 69 69 69 62 0 0 0 0 0 0 0 
0 0 0 0 0 0 0 0 100 90 100 90 91 98 90 100 90 91 98 90 90 82 90 82 90 90 100 90 100 89 92 92 92 92 92 101 90 90 90 103 0 0 0 0 0 0 0 0 0 0 0 0 0 76 69 69 70 70 70 70 70 70 69 71 71 71 71 71 71 69 71 71 71 71 71 71 71 77 77 72 73 73 73 73 73 74 77 77 71 71 69 69 71 74 0 0 0 0 0 0 
0 0 0 0 0 0 0 0 100 90 100 90 100 90 90 100 90 90 100 92 92 92 92 92 98 90 100 92 101 90 90 90 82 90 90 100 90 99 90 103 0 0 0 0 0 0 0 0 0 0 0 0 0 76 69 69 69 70 69 71 70 70 69 71 71 71 71 69 69 70 70 70 69 69 69 69 77 77 72 69 69 71 72 73 74 69 74 77 77 71 69 69 71 62 0 0 0 0 0 0 
0 0 0 0 0 0 0 0 100 90 100 92 101 98 82 100 90 91 101 90 90 90 90 89 100 90 90 82 90 90 91 92 92 98 90 100 90 100 90 103 0 0 0 0 0 0 0 0 0 0 0 0 0 76 69 69 70 77 70 70 69 69 69 75 69 71 71 69 71 71 71 70 71 71 71 71 77 72 69 69 72 73 69 69 69 74 69 74 77 77 69 69 71 62 0 0 0 0 0 0 
0 0 0 0 0 0 0 0 100 82 90 82 90 100 89 100 90 100 90 90 91 92 98 90 100 92 92 92 92 92 101 90 90 100 89 100 90 100 92 103 0 0 0 0 0 0 0 0 0 0 0 0 0 67 76 69 70 70 71 69 69 69 72 69 73 74 71 69 69 69 71 70 71 71 69 69 72 69 69 72 69 69 69 75 69 69 74 69 74 77 69 69 71 62 0 0 0 0 0 0 
0 0 0 0 0 0 0 0 100 90 91 92 92 101 90 100 90 100 89 91 101 90 100 90 100 90 90 82 82 90 80 90 100 101 90 100 90 100 90 100 0 0 0 0 0 0 0 0 0 0 0 0 0 0 76 69 69 69 71 69 69 72 69 69 75 69 74 71 69 69 69 69 71 71 71 72 69 69 72 69 77 72 73 69 74 69 62 69 69 74 69 69 71 62 0 0 0 0 0 0 
0 0 0 0 0 0 0 0 100 90 90 90 90 90 90 100 90 100 90 100 90 90 100 90 100 90 91 92 92 92 92 92 101 90 90 100 89 100 90 100 0 0 0 0 0 0 0 0 0 0 0 0 0 0 76 69 69 69 71 71 69 65 76 69 65 62 67 71 71 71 71 69 71 71 71 76 69 69 76 69 77 67 63 67 67 69 62 69 69 69 74 69 62 65 0 0 0 0 0 0 
0 0 0 0 0 0 0 0 100 92 92 92 92 92 92 101 90 100 90 100 80 91 101 89 100 90 100 90 90 90 80 90 90 90 100 101 90 100 90 100 0 0 0 0 0 0 0 0 0 0 0 0 0 0 67 65 76 69 69 71 71 71 65 76 62 67 71 71 69 69 71 71 71 71 71 64 76 69 65 65 76 69 67 69 69 62 67 69 69 69 62 69 62 0 0 0 0 0 0 0 
0 0 0 0 0 0 0 0 100 82 90 80 90 82 90 100 89 100 90 100 90 100 90 90 100 90 90 90 91 92 92 92 92 90 100 90 90 90 90 100 0 0 0 0 0 0 0 0 0 0 0 0 0 0 0 0 76 69 69 69 69 71 69 65 66 69 69 69 71 71 69 69 71 69 69 69 64 76 69 69 65 76 69 62 67 67 71 77 62 65 67 69 62 0 0 0 0 0 0 0 
0 0 0 0 0 0 0 0 100 92 92 92 92 92 90 100 90 100 90 100 90 100 90 91 101 92 98 90 100 90 90 90 100 92 101 98 90 98 90 100 0 0 0 0 0 0 0 0 0 0 0 0 0 0 0 0 67 76 69 69 69 71 71 69 69 71 71 71 71 69 71 71 71 71 69 69 69 64 76 69 69 67 67 67 69 69 62 67 67 69 69 62 66 0 0 0 0 0 0 0 
0 0 0 0 0 0 0 0 100 80 90 90 82 90 82 100 90 82 90 100 90 100 90 82 90 80 100 89 100 90 100 90 90 90 90 100 92 101 90 100 0 0 0 0 0 0 0 0 0 0 0 0 0 0 0 0 0 67 76 69 69 71 71 71 71 71 69 69 71 71 71 71 71 71 71 71 71 69 64 67 76 69 69 69 69 69 62 70 69 62 67 66 0 0 0 0 0 0 0 0 
0 0 0 0 0 0 0 0 100 92 92 92 92 92 90 100 92 92 92 101 90 100 92 92 92 90 100 91 102 90 100 89 91 92 92 101 90 100 82 100 0 0 0 0 0 0 0 0 0 0 0 0 0 0 0 0 0 0 67 76 69 69 71 71 69 69 69 69 71 71 71 71 71 71 71 71 71 71 69 70 67 67 76 69 62 67 67 70 69 62 0 0 0 0 0 0 0 0 0 0 
0 0 0 0 0 0 0 0 100 90 82 90 90 80 90 90 90 90 80 90 90 90 90 90 100 90 90 82 82 90 100 90 100 90 90 90 90 90 82 100 0 0 0 0 0 0 0 0 0 0 0 0 0 0 0 0 0 0 0 67 76 69 69 71 71 71 71 71 71 69 69 69 69 71 71 71 71 71 71 71 71 71 67 67 67 69 69 62 65 66 0 0 0 0 0 0 0 0 0 0 
0 0 0 0 0 0 0 0 100 90 99 90 100 100 90 91 92 92 92 92 92 92 92 89 100 92 92 92 92 92 101 90 100 92 92 92 92 98 90 100 0 0 0 0 0 0 0 0 0 0 0 0 0 0 0 0 0 0 0 0 67 65 76 69 69 69 69 69 69 69 69 69 69 69 69 69 69 69 69 69 69 69 69 69 69 62 65 66 0 0 0 0 0 0 0 0 0 0 0 0 
0 0 0 0 0 0 0 0 100 90 100 90 100 90 90 100 90 90 100 90 100 90 100 90 100 90 90 80 82 90 100 90 90 90 82 90 90 100 90 100 0 0 0 0 0 0 0 0 0 0 0 0 0 0 0 0 0 0 0 0 0 0 67 65 65 65 65 65 65 76 69 69 69 70 69 69 69 69 69 69 62 65 65 65 65 66 0 0 0 0 0 0 0 0 0 0 0 0 0 0 
0 0 0 0 0 0 0 0 100 90 100 89 100 89 100 101 98 90 90 90 100 90 100 90 100 90 99 90 99 90 100 98 90 91 92 92 82 90 82 100 0 0 0 0 0 0 0 0 0 0 0 0 0 0 0 0 0 0 0 0 0 0 0 0 0 0 0 0 0 67 65 66 76 70 70 70 62 65 65 65 66 0 0 0 0 0 0 0 0 0 0 0 0 0 0 0 0 0 0 0 
0 0 0 0 0 0 0 0 100 90 100 90 100 90 100 90 100 98 82 91 101 90 100 90 100 90 100 92 101 90 90 100 92 101 90 100 90 99 90 100 0 0 0 0 0 0 0 0 0 0 0 0 0 0 0 0 0 0 0 0 0 0 0 0 0 0 0 0 0 0 0 0 76 70 70 70 62 0 0 0 0 0 0 0 0 0 0 0 0 0 0 0 0 0 0 0 0 0 0 0 
0 0 0 0 0 0 0 0 100 90 100 90 100 90 90 90 100 90 90 90 100 89 100 90 90 90 100 90 82 90 90 90 90 80 90 100 90 100 90 100 0 0 0 0 0 0 0 0 0 0 0 0 0 0 0 0 0 0 0 0 0 0 0 0 0 0 0 0 0 0 0 0 76 70 70 70 62 0 0 0 0 0 0 0 0 0 0 0 0 0 0 0 0 0 0 0 0 0 0 0 
0 0 0 0 0 0 0 0 100 90 100 92 101 90 91 92 101 101 82 91 101 90 100 92 92 92 101 90 92 92 92 92 92 92 92 101 82 100 90 100 0 0 0 0 0 0 0 0 0 0 0 0 0 0 0 0 0 0 0 0 0 0 0 0 0 0 0 0 0 0 0 0 76 70 70 70 62 0 0 0 0 0 0 0 0 0 0 0 0 0 0 0 0 0 0 0 0 0 0 0 
0 0 0 0 0 0 0 0 100 90 90 82 90 90 90 80 90 90 90 82 82 90 90 90 100 90 90 90 100 90 90 90 82 90 90 90 90 100 90 100 0 0 0 0 0 0 0 0 0 0 0 0 0 0 0 0 0 0 0 0 0 0 0 0 0 0 0 0 0 0 0 0 76 70 70 70 62 0 0 0 0 0 0 0 0 0 0 0 0 0 0 0 0 0 0 0 0 0 0 0 
0 0 0 0 0 0 0 0 100 92 92 92 92 92 92 92 92 92 92 92 92 92 92 92 92 92 92 92 92 92 92 92 92 82 92 92 92 92 92 100 0 0 0 0 0 0 0 0 0 0 0 0 0 0 0 0 0 0 0 0 0 0 0 0 0 0 0 0 0 0 0 0 76 70 70 70 62 0 0 0 0 0 0 0 0 0 0 0 0 0 0 0 0 0 0 0 0 0 0 0 
0 0 0 0 0 0 0 0 105 105 105 105 105 105 105 105 105 105 105 105 105 105 105 105 105 105 105 105 105 105 105 100 93 87 104 100 105 105 105 105 105 0 0 0 0 0 0 0 0 0 0 0 0 0 0 0 0 0 0 0 0 0 0 0 0 0 0 0 0 0 0 0 76 70 70 70 62 0 0 0 0 0 0 0 0 0 0 0 0 0 0 0 0 0 0 0 0 0 0 0 
0 0 0 0 0 0 0 0 0 0 0 0 0 0 0 0 0 0 0 0 0 0 0 0 0 0 0 0 0 0 0 100 86 85 85 100 0 0 0 0 0 0 0 0 0 0 0 0 0 0 0 0 0 0 0 0 0 0 0 0 0 0 0 0 0 0 0 0 0 0 0 0 76 70 70 70 62 0 0 0 0 0 0 0 0 0 0 0 0 0 0 0 0 0 0 0 0 0 0 0 
0 0 0 0 0 0 0 0 0 0 0 0 0 0 0 0 0 0 0 0 0 0 0 0 0 0 0 0 0 0 0 100 85 85 85 100 0 0 0 0 0 0 0 0 0 0 0 0 0 0 0 0 0 0 0 0 0 0 0 0 0 0 0 0 0 0 0 0 0 0 0 0 76 70 70 77 62 0 0 0 0 0 0 0 0 0 0 0 0 0 0 0 0 0 0 0 0 0 0 0 
0 0 0 0 0 0 0 0 0 0 0 0 0 0 0 0 0 0 0 0 0 0 0 0 0 0 0 0 0 0 0 100 85 85 85 100 0 0 0 0 0 0 0 0 0 0 0 0 0 0 0 0 0 0 0 0 0 0 0 0 0 0 0 0 0 0 0 0 0 0 0 0 76 70 70 77 62 0 0 0 0 0 0 0 0 0 0 0 0 0 0 0 0 0 0 0 0 0 0 0 
0 0 0 0 0 0 0 0 0 0 0 0 0 0 0 0 0 0 0 0 0 0 0 0 0 0 0 0 0 0 0 100 85 87 85 100 0 0 0 0 0 0 0 0 0 0 0 0 0 0 0 0 0 0 0 0 0 0 0 0 0 0 0 0 0 0 0 0 0 0 0 0 76 70 70 77 62 0 0 0 0 0 0 0 0 0 0 0 0 0 0 0 0 0 0 0 0 0 0 0 
0 0 0 0 0 0 0 0 0 0 0 0 0 0 0 0 0 0 0 0 0 0 0 0 0 0 0 0 0 0 0 100 84 85 86 100 0 0 0 0 0 0 0 0 0 0 0 0 0 0 0 0 0 0 0 0 0 0 0 0 0 0 0 0 0 0 0 0 0 0 0 0 76 70 70 77 62 0 0 0 0 0 0 0 0 0 0 0 0 0 0 0 0 0 0 0 0 0 0 0 
0 0 0 0 0 0 0 0 0 0 0 0 0 0 0 0 0 0 0 0 0 0 0 0 0 0 0 0 0 0 0 100 87 84 85 100 0 0 0 0 0 0 0 0 0 0 0 0 0 0 0 0 0 0 0 0 0 0 0 0 0 0 0 0 0 0 0 91 92 92 92 92 98 71 71 71 98 92 92 92 92 98 0 0 0 0 0 0 0 0 0 0 0 0 0 0 0 0 0 0 
0 0 0 0 0 0 0 0 0 0 0 0 0 0 0 0 0 0 0 0 0 0 0 0 0 0 0 0 0 0 0 100 85 85 85 100 0 0 0 0 0 0 0 0 0 0 0 0 0 0 0 0 0 0 0 0 0 0 0 0 0 0 0 0 0 0 0 100 105 105 105 105 105 78 78 78 105 105 105 105 105 100 0 0 0 0 0 0 0 0 0 0 0 0 0 0 0 0 0 0 
0 0 0 0 0 0 0 0 0 0 0 0 0 0 0 0 0 0 0 0 0 0 0 0 0 0 0 0 0 0 0 100 85 87 85 100 215 0 0 0 0 0 0 0 0 0 0 0 0 0 0 0 0 0 0 0 0 0 0 0 0 0 0 0 0 0 0 100 78 78 78 78 78 78 78 78 78 78 78 78 78 100 0 0 0 0 0 0 0 0 0 0 0 0 0 0 0 0 0 0 
0 0 0 0 0 0 0 0 0 0 0 0 0 0 0 0 0 0 0 0 0 0 0 0 0 91 92 92 92 92 92 101 85 85 85 101 92 92 92 92 92 92 98 0 0 0 0 0 0 0 0 0 0 0 0 0 0 0 0 0 0 0 0 0 0 0 0 100 78 78 78 78 78 78 78 78 78 78 78 78 78 100 0 0 0 0 0 0 0 0 0 0 0 0 0 0 0 0 0 0 
0 0 0 0 0 0 0 0 0 0 0 0 0 0 0 0 0 0 0 0 0 0 0 0 0 100 105 105 105 105 105 93 85 85 85 104 105 105 105 105 105 105 100 0 0 0 0 0 0 0 0 0 0 0 0 0 0 0 0 0 0 0 0 0 0 0 0 100 78 78 78 78 78 78 78 78 78 78 78 78 78 100 0 0 0 0 0 0 0 0 0 0 0 0 0 0 0 0 0 0 
0 0 0 0 0 0 0 0 0 0 0 0 0 0 0 0 0 0 0 0 0 0 0 0 0 100 85 85 88 85 85 85 87 87 85 84 88 85 85 85 84 85 100 0 0 0 0 0 0 0 0 0 0 0 0 0 0 0 0 0 0 0 0 0 0 0 0 100 78 78 78 78 78 78 78 78 78 78 78 78 78 100 0 0 0 0 0 0 0 0 0 0 0 0 0 0 0 0 0 0 
0 0 0 0 0 0 0 0 0 0 0 0 0 0 0 0 0 0 0 0 0 0 0 0 0 100 85 84 85 85 85 84 85 87 85 84 85 87 85 85 85 86 100 0 0 0 0 0 0 0 0 0 0 0 0 0 0 0 0 0 0 0 0 0 0 0 0 100 78 78 78 78 78 78 78 78 78 78 78 78 78 100 0 0 0 0 0 0 0 0 0 0 0 0 0 0 0 0 0 0 
0 0 0 0 0 0 0 0 0 0 0 0 0 0 0 0 0 0 0 0 0 0 0 0 0 100 85 85 87 85 87 84 88 86 85 83 84 85 87 84 83 86 100 0 0 0 0 0 0 0 0 0 0 0 0 0 0 0 0 0 0 0 0 0 0 0 0 100 92 92 92 92 92 92 92 92 92 92 92 92 92 101 0 0 0 0 0 0 0 0 0 0 0 0 0 0 0 0 0 0 
0 0 0 0 0 0 0 0 0 0 0 0 0 0 0 0 0 0 0 0 0 0 0 0 0 100 85 87 85 87 86 85 85 87 85 87 83 86 83 85 85 85 100 0 0 0 0 0 0 0 0 0 0 0 0 0 0 0 0 0 0 0 0 0 0 0 0 105 105 105 105 105 105 105 105 105 105 105 105 105 105 105 0 0 0 0 0 0 0 0 0 0 0 0 0 0 0 0 0 0 
0 0 0 0 0 0 0 0 0 0 0 0 0 0 0 0 0 0 0 0 0 0 0 0 0 100 85 85 84 90 86 87 83 88 83 85 85 85 84 83 85 85 100 0 0 0 0 0 0 0 0 0 0 0 0 0 0 0 0 0 0 0 0 0 0 0 0 0 0 0 0 0 0 0 0 0 0 0 0 0 0 0 0 0 0 0 0 0 0 0 0 0 0 0 0 0 0 0 0 0 
0 0 0 0 0 0 0 0 0 0 0 0 0 0 0 0 0 0 0 0 0 0 0 0 0 100 85 85 83 83 88 85 85 85 83 83 87 85 85 86 86 85 100 0 0 0 0 0 0 0 0 0 0 0 0 0 0 0 0 0 0 0 0 0 0 0 0 0 0 0 0 0 0 0 0 0 0 0 0 0 0 0 0 0 0 0 0 0 0 0 0 0 0 0 0 0 0 0 0 0 
0 0 0 0 0 0 0 0 0 0 0 0 0 0 0 0 0 0 0 0 0 0 0 0 0 100 87 85 84 85 85 85 85 85 87 85 85 85 85 85 85 85 100 0 0 0 0 0 0 0 0 0 0 0 0 0 0 0 0 0 0 0 0 0 0 0 0 0 0 0 0 0 0 0 0 0 0 0 0 0 0 0 0 0 0 0 0 0 0 0 0 0 0 0 0 0 0 0 0 0
0 0 0 0 0 0 0 0 0 0 0 0 0 0 0 0 0 0 0 0 0 0 0 0 0 100 85 85 85 86 85 85 86 85 85 85 87 87 85 87 85 85 100 0 0 0 0 0 0 0 0 0 0 0 0 0 0 0 0 0 0 0 0 0 0 0 0 0 0 0 0 0 0 0 0 0 0 0 0 0 0 0 0 0 0 0 0 0 0 0 0 0 0 0 0 0 0 0 0 0
0 0 0 0 0 0 0 0 0 0 0 0 0 0 0 0 0 0 0 0 0 0 0 0 0 100 92 92 92 92 92 92 92 92 92 92 92 92 92 92 92 92 101 0 0 0 0 0 0 0 0 0 0 0 0 0 0 0 0 0 0 0 0 0 0 0 0 0 0 0 0 0 0 0 0 0 0 0 0 0 0 0 0 0 0 0 0 0 0 0 0 0 0 0 0 0 0 0 0 0 
0 0 0 0 0 0 0 0 0 0 0 0 0 0 0 0 0 0 0 0 0 0 0 0 0 95 105 105 105 105 105 105 105 96 96 105 105 105 105 105 105 105 95 0 0 0 0 0 0 0 0 0 0 0 0 0 0 0 0 0 0 0 0 0 0 0 0 0 0 0 0 0 0 0 0 0 0 0 0 0 0 0 0 0 0 0 0 0 0 0 0 0 0 0 0 0 0 0 0 0 
0 0 0 0 0 0 0 0 0 0 0 0 0 0 0 0 0 0 0 0 0 0 0 0 0 0 0 0 0 0 0 0 0 0 0 0 0 0 0 0 0 0 0 0 0 0 0 0 0 0 0 0 0 0 0 0 0 0 0 0 0 0 0 0 0 0 0 0 0 0 0 0 0 0 0 0 0 0 0 0 0 0 0 0 0 0 0 0 0 0 0 0 0 0 0 0 0 0 0 0 
0 0 0 0 0 0 0 0 0 0 0 0 0 0 0 0 0 0 0 0 0 0 0 0 0 0 0 0 0 0 0 0 0 0 0 0 0 0 0 0 0 0 0 0 0 0 0 0 0 0 0 0 0 0 0 0 0 0 0 0 0 0 0 0 0 0 0 0 0 0 0 0 0 0 0 0 0 0 0 0 0 0 0 0 0 0 0 0 0 0 0 0 0 0 0 0 0 0 0 0 
0 0 0 0 0 0 0 0 0 0 0 0 0 0 0 0 0 0 0 0 0 0 0 0 0 0 0 0 0 0 0 0 0 0 0 0 0 0 0 0 0 0 0 0 0 0 0 0 0 0 0 0 0 0 0 0 0 0 0 0 0 0 0 0 0 0 0 0 0 0 0 0 0 0 0 0 0 0 0 0 0 0 0 0 0 0 0 0 0 0 0 0 0 0 0 0 0 0 0 0 
0 0 0 0 0 0 0 0 0 0 0 0 0 0 0 0 0 0 0 0 0 0 0 0 0 0 0 0 0 0 0 0 0 0 0 0 0 0 0 0 0 0 0 0 0 0 0 0 0 0 0 0 0 0 0 0 0 0 0 0 0 0 0 0 0 0 0 0 0 0 0 0 0 0 0 0 0 0 0 0 0 0 0 0 0 0 0 0 0 0 0 0 0 0 0 0 0 0 0 0 
0 0 0 0 0 0 0 0 0 0 0 0 0 0 0 0 0 0 0 0 0 0 0 0 0 0 0 0 0 0 0 0 0 0 0 0 0 0 0 0 0 0 0 0 0 0 0 0 0 0 0 0 0 0 0 0 0 0 0 0 0 0 0 0 0 0 0 0 0 0 0 0 0 0 0 0 0 0 0 0 0 0 0 0 0 0 0 0 0 0 0 0 0 0 0 0 0 0 0 0 
