18 18 18 18 18 18 18 18 18 18 18 18 18 18 18 18 18 18 18 18 18 18 18 18 18 18 18 18 18 18 18 18 18 18 18 18 18 18 18 18 18 18 18 18 18 18 18 18 18 18 
18 18 18 18 18 18 18 18 18 18 18 18 18 18 18 18 18 18 18 18 18 18 18 18 18 18 18 18 18 18 18 18 18 18 18 18 18 18 18 18 18 18 18 18 18 18 18 18 18 18 
18 18 18 18 18 18 18 18 18 18 18 18 18 18 18 18 18 18 18 18 18 18 18 18 18 18 18 18 18 18 18 18 18 18 18 18 18 18 18 18 18 18 18 18 18 18 18 18 18 18 
18 18 18 18 18 18 18 18 18 18 18 18 18 18 18 18 18 18 18 18 18 18 18 18 18 18 18 18 18 18 18 18 18 18 18 18 18 18 18 18 18 18 18 18 18 18 18 18 18 18 
18 18 18 18 18 18 18 18 18 18 18 18 18 18 18 18 18 18 18 18 18 18 18 18 18 18 18 18 18 18 18 18 18 18 18 18 18 18 18 18 18 18 18 18 18 18 18 18 18 18 
18 18 18 18 18 18 18 18 18 18 18 18 18 18 18 18 18 18 18 18 18 18 18 18 18 18 18 18 18 18 18 18 18 18 18 18 18 18 18 18 18 18 18 18 18 18 18 18 18 18 
18 18 18 18 18 18 18 18 18 18 18 18 18 18 18 18 18 18 18 18 18 18 18 18 18 18 18 18 18 18 18 18 18 18 18 18 18 18 18 18 18 18 18 18 18 18 18 18 18 18 
18 18 18 18 18 18 18 18 18 18 18 18 18 18 18 18 18 18 18 18 18 18 18 16 1 1 18 18 18 18 18 18 18 18 18 18 18 18 18 18 18 18 18 18 18 18 18 18 18 18 
18 18 18 18 18 18 18 18 18 18 18 18 18 18 18 18 1 1 2 2 1 1 1 1 1 16 1 1 1 16 1 1 18 18 18 18 18 18 18 18 18 18 18 18 18 18 18 18 18 18 
18 18 18 18 18 18 18 18 18 18 18 18 18 18 1 1 2 2 1 1 1 2 1 2 1 1 1 1 1 1 1 1 1 18 18 18 18 18 18 18 18 18 18 18 18 18 18 18 18 18 
18 18 18 18 18 18 18 18 18 18 18 18 18 1 1 32 32 32 32 32 32 32 32 32 32 32 32 32 32 32 32 32 32 1 18 18 18 18 18 18 18 18 18 18 18 18 18 18 18 18 
18 18 18 18 18 18 18 18 18 18 18 18 18 1 1 32 1 1 1 1 1 1 1 1 2 2 2 2 2 1 1 1 32 1 18 18 18 18 18 18 18 18 18 18 18 18 18 18 18 18 
18 18 18 18 18 18 18 18 18 18 18 18 1 1 16 32 1 1 16 1 1 2 2 1 1 1 1 2 1 1 16 1 32 1 1 18 18 18 18 18 18 18 18 18 18 18 18 18 18 18 
18 18 18 18 18 18 18 18 18 18 18 1 1 1 1 32 1 1 2 1 1 1 20 21 21 21 21 21 22 1 1 1 32 1 1 1 18 18 18 18 18 18 18 18 18 18 18 18 18 18 
18 18 18 18 18 18 18 18 18 18 18 1 1 1 1 32 2 1 1 1 1 1 23 18 18 19 18 18 24 1 1 1 32 1 16 16 18 18 18 18 18 18 18 18 18 18 18 18 18 18 
18 18 18 18 18 18 18 18 18 18 18 1 16 1 1 32 1 1 1 1 1 20 31 18 18 18 19 18 30 22 1 1 32 1 1 1 18 18 18 18 18 18 18 18 18 18 18 18 18 18 
18 18 18 18 18 18 18 18 18 18 1 1 1 1 1 32 1 2 1 33 1 23 18 19 19 18 18 19 19 24 1 1 32 1 1 1 18 18 18 18 18 18 18 18 18 18 18 18 18 18 
18 18 18 18 18 18 18 18 18 18 1 1 2 1 1 32 1 1 12 10 13 25 29 18 18 19 19 18 28 27 1 1 32 1 16 1 18 18 18 18 18 18 18 18 18 18 18 18 18 18 
18 18 18 18 18 18 18 18 18 18 1 16 1 2 16 32 1 2 8 3 7 1 23 19 18 18 19 18 24 1 1 1 32 1 1 1 18 18 18 18 18 18 18 18 18 18 18 18 18 18 
18 18 18 18 18 18 18 18 18 18 1 1 2 2 1 32 2 2 8 3 9 10 25 26 26 26 26 26 27 1 1 1 32 1 16 1 18 18 18 18 18 18 18 18 18 18 18 18 18 18 
18 18 18 18 18 18 18 18 18 18 22 1 16 1 16 32 2 1 8 3 3 3 9 10 13 1 1 1 1 1 16 1 32 1 1 1 18 18 18 18 18 18 18 18 18 18 18 18 18 18 
18 18 18 18 18 18 18 18 18 18 24 1 1 1 1 32 1 1 14 5 5 6 3 3 9 10 10 13 1 1 1 1 32 16 1 20 18 18 18 18 18 18 18 18 18 18 18 18 18 18 
18 18 18 18 18 18 18 18 18 18 24 1 16 1 1 32 32 32 32 32 32 32 6 3 3 3 3 7 32 32 32 32 32 1 20 31 18 18 18 18 18 18 18 18 18 18 18 18 18 18 
18 18 18 18 18 18 18 18 18 18 30 21 22 1 16 1 1 16 1 1 1 1 14 6 3 3 3 7 1 1 1 20 21 21 31 18 18 18 18 18 18 18 18 18 18 18 18 18 18 18 
18 18 18 18 18 18 18 18 18 18 18 18 30 21 21 21 21 21 21 21 21 22 1 8 3 3 3 7 20 21 21 31 18 18 18 18 18 18 18 18 18 18 18 18 18 18 18 18 18 18 
18 18 18 18 18 18 18 18 18 18 18 18 18 18 18 18 18 18 18 18 18 24 1 8 3 3 3 7 23 18 18 18 18 18 18 18 18 18 18 18 18 18 18 18 18 18 18 18 18 18 
18 18 18 18 18 18 18 18 18 18 18 18 18 18 18 18 18 18 18 18 18 30 22 8 3 3 3 7 25 29 18 18 18 18 18 18 18 18 18 18 18 18 18 18 18 18 18 18 18 18 
18 18 18 18 18 18 18 18 18 18 18 18 18 18 18 18 18 18 18 18 18 28 27 8 3 3 3 7 1 25 29 18 18 18 18 18 18 18 18 18 18 18 18 18 18 18 18 18 18 18 
18 18 18 18 18 18 18 18 18 18 18 18 18 18 18 18 18 18 18 18 18 24 1 8 3 3 3 9 13 1 25 29 18 18 18 18 18 18 18 18 18 18 18 18 18 18 18 18 18 18 
18 18 18 18 18 18 18 18 18 18 18 18 18 18 18 18 18 18 18 28 26 27 1 8 3 3 3 3 9 13 1 25 29 18 18 18 18 18 18 18 18 18 18 18 18 18 18 18 18 18 
18 18 18 18 28 26 26 26 26 26 26 18 18 18 18 18 28 26 26 27 1 1 12 11 3 3 3 3 3 9 13 1 25 29 18 18 18 18 18 28 26 26 26 26 26 26 26 29 18 18 
18 18 18 28 27 1 1 1 1 1 1 25 26 29 28 26 27 1 1 12 10 10 11 3 3 3 3 3 3 3 7 1 1 25 26 26 26 26 26 27 1 1 1 1 1 1 1 25 29 18 
18 18 28 27 1 1 16 16 16 1 1 1 1 25 27 12 10 10 10 11 3 3 3 3 3 3 3 3 3 3 9 10 10 13 1 1 1 1 1 1 1 1 1 1 1 1 1 1 25 29 
18 28 27 1 1 16 16 1 16 16 1 1 12 10 10 11 3 3 3 3 3 3 3 3 3 4 5 5 5 6 3 3 3 7 32 32 32 32 32 32 32 32 32 32 32 32 32 32 1 23 
18 24 1 1 1 16 1 10 10 1 16 10 11 3 3 3 3 3 3 3 3 3 4 5 5 15 20 21 22 14 6 3 3 9 32 34 34 34 34 34 34 34 34 34 34 34 34 32 1 23 
18 24 1 1 16 16 11 3 3 9 11 3 3 3 3 3 3 4 5 5 5 5 15 20 21 21 31 18 30 22 14 6 3 3 34 34 34 34 34 34 34 34 34 34 34 35 34 32 1 23 
18 24 1 16 16 8 3 3 3 3 3 3 3 4 5 5 5 15 1 1 1 1 20 31 18 18 18 18 28 27 1 8 3 3 34 34 34 35 34 34 34 34 34 34 34 34 34 32 1 23 
18 30 22 16 16 16 6 3 3 3 3 3 3 1 1 1 1 1 1 1 1 20 31 18 18 18 18 18 24 1 1 8 3 3 34 34 34 34 34 34 34 34 34 34 34 34 34 32 1 23 
18 18 18 22 1 16 16 6 3 3 3 3 4 1 1 16 1 1 1 20 21 31 18 18 18 18 18 18 24 1 1 14 6 3 34 34 34 34 34 34 34 35 34 34 34 34 34 32 1 23 
18 18 18 24 1 1 16 1 6 3 3 3 7 1 1 16 20 21 21 31 18 18 18 18 18 18 18 18 24 1 1 1 14 5 32 34 34 34 34 34 34 34 34 34 34 34 34 32 1 23 
18 18 18 30 21 22 1 1 16 6 3 3 7 1 16 16 23 18 18 18 18 18 18 18 18 18 18 18 30 22 1 1 1 1 32 32 32 32 32 32 32 32 32 32 32 32 32 32 1 23 
18 18 18 18 18 30 22 1 16 1 5 5 16 16 16 20 31 18 18 18 18 18 18 18 18 18 18 18 18 30 22 1 1 1 1 1 1 1 1 1 1 1 1 1 1 1 1 1 1 23 
18 18 18 18 18 18 30 22 1 1 16 16 16 16 20 31 18 18 18 18 18 18 18 18 18 18 18 18 18 18 30 21 22 1 1 1 1 20 21 21 21 21 22 1 1 1 1 20 21 31 
18 18 18 18 18 18 18 30 21 21 21 21 21 21 31 18 18 18 18 18 18 18 18 18 18 18 18 18 18 18 18 18 30 21 21 21 21 31 18 18 18 18 30 21 21 21 21 31 18 18 
18 18 18 18 18 18 18 18 18 18 18 18 18 18 18 18 18 18 18 18 18 18 18 18 18 18 18 18 18 18 18 18 18 18 18 18 18 18 18 18 18 18 18 18 18 18 18 18 18 18 
18 18 18 18 18 18 18 18 18 18 18 18 18 18 18 18 18 18 18 18 18 18 18 18 18 18 18 18 18 18 18 18 18 18 18 18 18 18 18 18 18 18 18 18 18 18 18 18 18 18 
18 18 18 18 18 18 18 18 18 18 18 18 18 18 18 18 18 18 18 18 18 18 18 18 18 18 18 18 18 18 18 18 18 18 18 18 18 18 18 18 18 18 18 18 18 18 18 18 18 18 
18 18 18 18 18 18 18 18 18 18 18 18 18 18 18 18 18 18 18 18 18 18 18 18 18 18 18 18 18 18 18 18 18 18 18 18 18 18 18 18 18 18 18 18 18 18 18 18 18 18 
18 18 18 18 18 18 18 18 18 18 18 18 18 18 18 18 18 18 18 18 18 18 18 18 18 18 18 18 18 18 18 18 18 18 18 18 18 18 18 18 18 18 18 18 18 18 18 18 18 18 
18 18 18 18 18 18 18 18 18 18 18 18 18 18 18 18 18 18 18 18 18 18 18 18 18 18 18 18 18 18 18 18 18 18 18 18 18 18 18 18 18 18 18 18 18 18 18 18 18 18 
